1111111111111
1P01001000011
1000011111001
1000110000001
1001000100101
1111111111111