1111111111111
1P0100C0000C1
1000011111001
1000110000001
100C000C00C01
1111111111111