1111111111111
1P0100C0000C1
1000011111001
100011E000001
100C000C00C00
1111111111111